hoof	noun
horse	noun
human	noun
human_setting	noun
leg	noun
mammal	noun
mane	noun
mouth	noun
ruminant	noun
snout	noun
stand	verb
tail	noun
traction	noun
wilderness	noun
wing	noun
eat	verb
fly	verb
hear	verb
neigh	verb
run	verb
see	verb
walk	verb
food	noun
cargo	noun
